벽 : 0
공백 : 1
small dot : 2
large dot : 3
"//layout" 아래줄부터 맵 레이아웃 작성
//layout
0000000000000000000000000000
0011111000111110001111100000
1110001111100011111000111111
0011111000111110001111100010
1110001111100011111000111111
0012111000111110001111100010
1110001111100011111000113111
0011111000111110001111100010
1110001111100011111000111111
0011111000111110001111100010
1110001111100011111000111111
0011111000111110001111100010
0000100000100010000010001110
1111100111111111111111111011
0100000100000010000010000010
0111111111111111111111111110
0100000100000100000010000010
0111111111111111111111111110
0100000100000100000010000010
0111111111111111111111111110
0010101010101010101010101010
0010101010101010101010101010
0010101010101010101010101010
0111111111111111111111111110
0101010101010101010101010100
0101010101010101010101010100
0101010101010101010101010100
0111111111111111111111111110
1100000000000000000000000011
0000000000000000000000000000