벽 : 0
공백 : 1
small dot : 2
large dot : 3
"//layout" 아래줄부터 맵 레이아웃 작성
//layout
0000000000000000000000000000
0222222222001111002222222220
0200000002001001002000000020
0200000002001001002000000020
0322222222001001002222222230
0100001001001001001001000010
0100001001001001001001000010
1111111001001001001001111111
0000001001111001111001000000
0000001000001001000001000000
0222222000001001000002222220
0200002111111111111112000020
0200002001000100001002000020
0200002001000100001002000020
0200002001111111111002000020
0200002001000000001002000020
0222222111111111111112222220
0000100000001001000000010000
0000100000001001000000010000
1111100111111001111110011111
0100100100000000000010010010
0100100100000000000010010010
0222200111111111111110022220
0200200000001001000000020020
0200200000001001000000020020
0300200222222002222220020030
0200200200002002000020020020
0200200200002002000020020020
0222211222222002222221122220
0000000000000000000000000000