벽 : 0
공백 : 1
small dot : 2
large dot : 3
"//layout" 아래줄부터 맵 레이아웃 작성
//layout
0000000000000000000000000000
0111111111001111001111111110
0100000001001001001000000010
0100000001001001003000000010
0111111111001001001111111110
0000002001001001001001000000
0000001001001001001001000000
1111111001001001001001111111
0000001001111001111001000000
0000001000001001000001000000
0111111000001001000001111110
0100001001111111111001000010
0100001001000100001001000010
0100001001000100001001000010
0100001001111111111001000010
0100001001000000001001000010
0111111111111111111111111110
0000100000001001000000010000
0000100000001001000000010000
1111100111111001111110011111
0000100100000000000010010000
0000100100000000000010010000
0111100111111111111110011110
0100100000001001000000010010
0100100000001001000000010010
0100100111111001111110010010
0100100100001001000010010010
0100100100001001000010010010
0111111111111001111111111110
0000000000000000000000000000