벽 : 0
공백 : 1
small dot : 2
large dot : 3
"//layout" 아래줄부터 맵 레이아웃 작성
//layout
0000000000000000000000000000
0022222000111110002222200000
1120002111100011112000211111
0022322000111110002222200010
1110001111100011111000111111
0011111000222220001111100010
1110001111200021111000111111
0011111000222220001111100010
1110001111100011111000111111
0022222000111110002232200010
1120002111100011112000211111
0022222000111110002222200010
0000100000100010000010001110
1111111111111111111111111011
0100000100000010000010000010
0111111111111111111111111110
0100000100000100000010000010
0222211111222222211111222220
0200200000200000200000200020
0222211111222222211111222220
0010101010101010101010101010
0010101010101010101010101010
0010101010101010101010101010
0122223222222222222222222210
0101010101010101010101010100
0101010101010101010101010100
0101010101010101010101010110
0122222222222222222322222210
1100000000000000000000000011
0000000000000000000000000000
