벽 : 0
공백 : 1
small dot : 2
large dot : 3
"//layout" 아래줄부터 맵 레이아웃 작성
//layout
0000000000000000000000000000
0222222223222002223222222220
0200001000002002000001000020
0200001000002002000001000020
0222222222222112222222222220
0100001001000000001001000010
0100001001000000001001000010
0111111001111001111001111110
0000001000001001000001000000
1111101000001001000001011111
1111101001111111111001011111
1111101001000010001001011111
0000001001011111101001000000
1111111111110000111111111111
0000001001011111101001000000
1111101001000100001001011111
1111101001111111111001011111
1111101001000000001001011111
0000001001000000001001000000
0111111111111001111111111110
0100001000001001000001000010
0100001000001001000001000010
0111002222222222222222001110
0001002001000000001002001000
0001002001000000001002001000
0222322001111001111002232220
0200000000001001000000000020
0200000000001001000000000020
0222222222222222222222222220
0000000000000000000000000000



