벽 : 0
공백 : 1
small dot : 2
large dot : 3
"//layout" 아래줄부터 맵 레이아웃 작성
//layout
0000000000000000000000000000
0111111111111111111111111110
0100001000001001000001000010
0200001000001001000003000010
0111111111111111111111111110
0100001001000000001001000010
0100001001000000001001000010
0111111001111001111001111110
0000001000001001000001000000
1111101000001001000001011111
1111101001111111111001011111
1111101001000010001001011111
0000001001011111101001000000
1111111111110000111111111111
0000001001011111101001000000
1111101001000100001001011111
1111101001111111111001011111
1111101001000000001001011111
0000001001000000001001000000
0111111111111001111111111110
0100001000001001000001000010
0100001000001001000001000010
0111001111111111111111001110
0001001001000000001001001000
0001001001000000001001001000
0111111001111001111001111110
0100000000001001000000000010
0100000000001001000000000010
0111111111111111111111111110
0000000000000000000000000000



