벽 : 0
공백 : 1
small dot : 2
large dot : 3
"//layout" 아래줄부터 맵 레이아웃 작성
//layout
0000000000000000000000000000
0022222000222220002222200000
1120002222200022222000222221
0022322000222220002222200020
1120002222200022222000222221
0022222000222220002222200020
1120002222200022222000222221
0022222000222220002222200020
1120002222200022222000222221
0022222000222220002232200020
1120002222200022222000222221
0022222000222220002222200010
0000100000100010000010001110
1111100111111111111111111011
0100000100000010000010000010
0222222222222222222222222220
0200000200000200000020000020
0222222222222222222222222220
0200200000200000200000200020
0222222222222222222222222220
0020202020202020202020202020
0020202020202020202020202020
0020302020202020202020202020
0222222222222222222222222220
0202020202020202020202020200
0202020202020202020202020300
0202020202020202020202020200
0222222222222222222222222220
1100000000000000000000000011
0000000000000000000000000000