벽 : 0
공백 : 1
small dot : 2
large dot : 3
"//layout" 아래줄부터 맵 레이아웃 작성
//layout
0000000000000000000000000000
0222222222002222002222222220
0200000002002002002000000020
0200000002002002002000000020
0322222222002002002222222230
0000002002002002002002000000
0000002002002002002002000000
1111112002002002002002111111
0000002002222002222002000000
0000002000002002000002000000
0222222000001001000002222220
0200002001111111111002000020
0200002001000110001002000020
0200002001011111101002000020
0200002001011111101002000020
0200002001000000001002000020
0222222111111111111112222220
0000200000001001000000020000
0000200000001001000000020000
1111200222221001222220021111
0000200200000000000020020000
0000200200000000000020020000
0222200222222222222220022220
0200200000002002000000020020
0200200000002002000000020020
0300200222222002222220020030
0200200200002002000020020020
0200200200002002000020020020
0222222222222002222222222220
0000000000000000000000000000